111111111111111111111111111111
111111111000000000000000000001
1P0000000000000000GEG111111111
1CCCCCCCCCCCCCCCCCCGCCCCCCCCC1
100000000000000000000000000001
111111111111111111111111111111