111111111111111111111
10000001G00G100000001
10110001100110C001101
101001000000110100101
111101011111100001101
1P00000000000000000E1
111111111111111110111
111111111111111111111