111111111111111111111
10000001G00G100000001
101100011001100001101
10100100C000000100101
101101011111100101101
1P00000000000000000E1
111111111111111111111
