111111111111111111111
1CCCCCC1GGCC1CCCCCCC1
1C11CCC11CC11CCCC11C1
1C1CC1CCCCCC11C1CC1C1
1111C1C111111CCCC11C1
1PCCCCCCCCCCCCCCCCCE1
111111111111111111111