111111111111111111111
100E0001G00G100000001
101100011001100001101
10100100C000000100101
101101011111100101101
100000000P00000000001
111111111111111111111
