1111
10C1
1G01
1P01
1E01
1111
